13	11	11	11	11	11	11	11	11	12
17	4	4	8	6	4	7	6	6	10
17	4	8	8	4	0	8	1	2	10
17	8	9	4	8	0	7	1	0	10
17	6	8	2	9	9	2	8	1	10
17	5	2	5	2	9	3	8	2	10
17	6	9	9	9	9	2	2	8	10
17	0	0	6	9	5	2	7	2	10
17	6	8	9	9	8	6	5	7	10
16	14	14	14	14	14	14	14	14	15
