13	11	11	11	11	11	11	11	11	12
17	1	0	4	7	5	1	7	4	10
17	6	0	1	4	1	5	8	8	10
17	1	9	6	2	3	8	1	0	10
17	8	4	1	9	9	0	5	3	10
17	3	2	7	0	9	4	1	6	10
17	7	9	6	9	9	3	8	4	10
17	4	8	2	9	5	2	1	5	10
17	8	1	4	9	7	1	6	6	10
16	14	14	14	14	14	14	14	14	15
