13	11	11	11	11	11	11	11	11	12
17 	3 	3 	3 	3 	3 	3 	3 	9 	10
17 	3 	3 	3	3 	3 	3 	3 	3 	10
17 	3 	9 	3 	2 	2 	2 	3 	3 	10
17 	3 	3 	3 	2 	9 	2 	3 	3 	10
17 	3 	3 	3 	2 	2 	2 	3 	3 	10
17 	3 	3 	3 	3 	3 	9 	3 	3 	10
17 	3 	3	9 	3 	3 	3 	3 	3 	10
17 	3 	3 	3 	3 	3 	3 	3 	3 	10
16	14	14	14	14	14	14	14	14	15