13	11	11	11	11	11	11	11	11	12
17 	9 	9 	9 	9 	9 	9 	9 	9 	10
17 	9 	3 	9	9 	9 	9 	9 	9 	10
17 	9 	9 	9 	3 	9 	9 	9 	9 	10
17 	9 	9 	9 	9 	3 	9 	9 	9 	10
17 	9 	9 	9 	3	3 	9 	9 	9 	10
17 	9 	9 	9 	9 	9 	9 	9 	9 	10
17 	9 	9	3 	3 	9 	9 	9 	9 	10
17 	9 	9 	9 	9 	9 	9 	9 	9 	10
16	14	14	14	14	14	14	14	14	15
